22 22 22 22 22 22 22 22 22 22 22 22 22 22 22 22 22 22 22 22 22 22 22 22 22 22 22 22 22 22 22 22 22 22 22 22 22 22 22 22 22 22 22 22 22 22 22 22 22 22 
22 22 22 22 22 22 22 22 22 22 22 22 22 22 22 22 22 22 22 22 22 22 22 22 22 22 22 22 22 22 22 22 22 22 22 22 22 22 22 22 22 22 22 22 22 22 22 22 22 22 
22 22 22 22 22 22 22 22 22 22 22 22 22 22 22 22 22 22 22 22 22 22 22 22 22 22 22 22 22 22 22 22 22 22 22 22 22 22 22 22 22 22 22 22 22 22 22 22 22 22 
22 22 22 22 22 22 22 22 22 22 22 22 22 22 22 22 22 22 22 22 22 22 22 22 22 22 22 22 22 22 22 22 22 22 22 22 22 22 22 22 22 22 22 22 22 22 22 22 22 22 
22 22 22 22 22 22 22 22 22 22 22 22 22 22 22 22 22 22 22 22 22 22 22 22 22 22 22 22 22 22 22 22 22 22 22 22 22 22 22 22 22 22 22 22 22 22 22 22 22 22 
22 22 22 22 22 22 22 22 22 22 22 22 22 22 22 22 22 22 22 22 22 22 22 22 22 22 22 22 22 22 22 22 22 22 22 22 22 22 22 22 22 22 22 22 22 22 22 22 22 22 
22 22 22 22 22 22 22 22 22 22 22 22 22 22 22 22 22 22 22 22 22 22 22 22 22 22 22 22 22 22 22 22 22 22 22 22 22 22 22 22 22 22 22 22 22 22 22 22 22 22 
22 22 22 22 22 22 22 22 36 25 25 25 25 25 25 25 25 25 25 25 25 25 25 25 25 25 25 25 25 25 25 25 25 25 25 25 25 25 25 25 25 25 39 22 22 22 22 22 22 22 
22 22 22 22 22 22 22 22 33 29 24 24 24 24 24 24 24 24 24 24 24 24 24 24 24 24 24 24 24 24 24 24 24 24 24 24 24 24 24 24 24 32 35 22 22 22 22 22 22 22 
22 22 22 22 22 22 22 22 33 26 40 23 23 23 23 40 41 42 47 23 23 23 23 23 23 23 23 23 23 23 23 23 23 23 23 23 23 23 23 23 23 28 35 22 22 22 22 22 22 22 
22 22 22 22 22 22 22 22 33 26 40 23 23 23 23 40 43 44 47 23 23 23 23 23 23 23 23 23 23 23 23 23 23 23 23 23 23 23 23 23 23 28 35 22 22 22 22 22 22 22 
22 22 22 22 22 22 22 22 33 26 40 23 23 23 23 40 45 46 47 23 23 23 23 23 23 23 23 23 23 23 23 23 23 23 23 23 23 23 23 23 23 28 35 22 22 22 22 22 22 22 
22 22 22 22 22 22 22 22 33 26 40 23 23 23 23 40 47 47 47 23 23 23 23 23 23 23 23 23 23 23 23 23 23 23 23 23 23 23 23 23 23 28 35 22 22 22 22 22 22 22 
22 22 22 22 22 22 22 22 33 26 40 23 23 23 23 40 23 23 23 23 23 23 23 23 23 62 61 23 23 23 23 23 23 23 23 23 23 23 23 23 23 28 35 22 22 22 22 22 22 22 
22 22 22 22 22 22 22 22 33 26 40 40 23 23 40 40 23 23 23 23 23 23 23 23 65 62 61 49 23 23 23 23 23 23 23 23 23 23 23 23 23 28 35 22 22 22 22 22 22 22 
22 22 22 22 22 22 22 22 33 26 23 23 23 23 23 23 23 23 23 23 23 23 23 23 65 62 61 49 23 23 23 23 23 23 23 23 23 23 23 23 23 28 35 22 22 22 22 22 22 22 
22 22 22 22 22 22 22 22 33 26 23 23 23 23 23 23 23 23 23 23 23 23 23 23 65 62 61 49 23 23 23 23 23 23 23 23 23 23 23 23 23 28 35 22 22 22 22 22 22 22 
22 22 22 22 22 22 22 22 33 26 23 23 23 23 23 23 23 23 23 23 23 23 23 23 65 62 61 49 23 23 23 23 23 23 23 23 23 23 23 23 23 28 35 22 22 22 22 22 22 22 
22 22 22 22 22 22 22 22 33 26 23 23 23 23 23 23 23 23 23 23 23 23 23 23 65 62 61 49 23 23 23 23 23 23 23 23 23 23 23 23 23 28 35 22 22 22 22 22 22 22 
22 22 22 22 22 22 22 22 33 26 23 23 23 23 23 23 23 23 23 23 23 23 23 23 23 62 61 49 23 23 23 23 23 23 23 23 23 23 23 23 23 28 35 22 22 22 22 22 22 22 
22 22 22 22 22 22 22 22 33 26 23 23 23 23 23 23 23 23 23 23 23 23 23 23 66 62 61 49 23 23 23 23 23 23 23 23 23 23 23 23 23 28 35 22 22 22 22 22 22 22 
22 22 22 22 22 22 22 22 33 26 23 23 23 23 23 23 23 23 23 23 66 66 23 23 66 62 61 23 23 23 23 23 23 23 23 23 23 23 23 23 23 28 35 22 22 22 22 22 22 22 
22 22 22 22 22 22 22 22 33 26 23 23 23 23 23 63 63 63 63 63 63 63 63 63 63 63 61 63 63 63 63 63 63 63 63 63 63 63 23 23 23 28 35 22 22 22 22 22 22 22 
22 22 22 22 22 22 22 22 33 26 23 23 23 23 23 64 64 64 64 64 64 64 64 64 64 62 61 64 64 64 64 64 64 64 64 64 64 64 23 23 23 28 35 22 22 22 22 22 22 22 
22 22 22 22 22 22 22 22 33 26 23 23 23 23 23 23 23 23 23 23 23 23 23 49 49 62 61 66 23 66 66 23 23 23 23 23 23 23 23 23 23 28 35 22 22 22 22 22 22 22 
22 22 22 22 22 22 22 22 33 26 23 23 23 23 23 23 23 23 23 23 23 23 23 23 49 62 61 66 23 23 23 23 23 23 23 23 23 23 23 23 23 28 35 22 22 22 22 22 22 22 
22 22 22 22 22 22 22 22 33 26 23 23 23 23 23 23 23 23 23 23 23 23 23 23 49 62 61 23 23 23 23 23 23 23 23 23 23 23 23 23 23 28 35 22 22 22 22 22 22 22 
22 22 22 22 22 22 22 22 33 26 23 23 23 23 23 23 23 23 23 23 23 23 23 23 23 62 61 23 23 23 23 23 23 23 23 23 23 23 23 23 23 28 35 22 22 22 22 22 22 22 
22 22 22 22 22 22 22 22 33 26 23 23 23 23 23 23 23 23 23 23 23 23 23 23 23 62 61 23 23 23 23 23 23 23 23 23 23 23 23 23 23 28 35 22 22 22 22 22 22 22 
22 22 22 22 22 22 22 22 33 26 23 23 23 23 23 23 23 23 23 23 23 23 23 23 23 62 61 23 23 23 23 23 23 23 23 23 23 23 23 23 23 28 35 22 22 22 22 22 22 22 
22 22 22 22 22 22 22 22 33 26 23 23 23 23 23 23 23 23 23 23 23 23 23 23 23 62 61 23 23 23 23 23 23 23 23 23 23 23 23 23 23 28 35 22 22 22 22 22 22 22 
22 22 22 22 22 22 22 22 33 26 23 23 23 23 23 23 23 23 23 23 23 23 23 23 23 62 61 23 23 23 23 23 23 23 23 23 23 23 23 23 23 28 35 22 22 22 22 22 22 22 
22 22 22 22 22 22 22 22 33 26 23 23 23 23 23 23 23 23 23 23 23 23 23 23 23 62 61 23 23 23 23 23 23 23 23 23 23 23 23 23 23 28 35 22 22 22 22 22 22 22 
22 22 22 22 22 22 22 22 33 26 23 23 23 23 23 23 23 23 23 23 23 23 23 23 23 62 61 23 23 23 23 23 23 23 23 23 23 23 23 23 23 28 35 22 22 22 22 22 22 22 
22 22 22 22 22 22 22 22 33 26 23 23 23 23 23 23 23 23 23 59 60 23 23 23 23 62 61 23 23 23 23 23 23 23 23 23 23 23 23 23 23 28 35 22 22 22 22 22 22 22 
22 22 22 22 22 22 22 22 33 26 23 23 23 23 23 23 23 23 23 62 61 23 23 23 23 62 61 23 23 23 23 23 23 23 23 23 23 23 23 23 23 28 35 22 22 22 22 22 22 22 
22 22 22 22 22 22 22 22 33 26 56 56 56 55 53 53 54 56 56 56 58 23 23 23 23 23 23 23 23 23 23 23 23 23 23 23 23 23 23 23 23 28 35 22 22 22 22 22 22 22 
22 22 22 22 22 22 22 22 33 26 23 23 23 23 52 52 23 23 23 23 23 23 23 23 23 23 23 23 23 23 23 23 23 23 23 23 23 23 23 23 23 28 35 22 22 22 22 22 22 22 
22 22 22 22 22 22 22 22 33 26 48 48 48 23 51 51 23 23 23 23 23 23 23 23 23 23 23 23 23 23 23 23 23 23 23 23 23 23 23 23 40 28 35 22 22 22 22 22 22 22 
22 22 22 22 22 22 22 22 33 26 41 42 48 49 51 51 65 23 23 23 23 23 23 23 23 23 23 23 23 23 23 23 23 23 23 23 23 23 23 23 40 28 35 22 22 22 22 22 22 22 
22 22 22 22 22 22 22 22 33 26 43 44 48 47 50 50 65 23 23 23 23 23 23 23 23 23 23 23 23 23 23 23 23 23 23 23 23 23 23 23 40 28 35 22 22 22 22 22 22 22
22 22 22 22 22 22 22 22 33 26 45 46 48 49 22 22 65 23 23 23 23 23 23 23 23 23 23 23 23 23 23 23 23 23 23 23 23 40 40 40 40 28 35 22 22 22 22 22 22 22 
22 22 22 22 22 22 22 22 33 30 27 27 27 27 22 22 27 27 27 27 27 27 27 27 27 27 27 27 27 27 27 27 27 27 27 27 27 27 27 27 27 31 35 22 22 22 22 22 22 22
22 22 22 22 22 22 22 22 37 34 34 34 34 34 22 22 34 34 34 34 34 34 34 34 34 34 34 34 34 34 34 34 34 34 34 34 34 34 34 34 34 34 38 22 22 22 22 22 22 22
22 22 22 22 22 22 22 22 22 22 22 22 22 22 22 22 22 22 22 22 22 22 22 22 22 22 22 22 22 22 22 22 22 22 22 22 22 22 22 22 22 22 22 22 22 22 22 22 22 22 
22 22 22 22 22 22 22 22 22 22 22 22 22 22 22 22 22 22 22 22 22 22 22 22 22 22 22 22 22 22 22 22 22 22 22 22 22 22 22 22 22 22 22 22 22 22 22 22 22 22
22 22 22 22 22 22 22 22 22 22 22 22 22 22 22 22 22 22 22 22 22 22 22 22 22 22 22 22 22 22 22 22 22 22 22 22 22 22 22 22 22 22 22 22 22 22 22 22 22 22 
22 22 22 22 22 22 22 22 22 22 22 22 22 22 22 22 22 22 22 22 22 22 22 22 22 22 22 22 22 22 22 22 22 22 22 22 22 22 22 22 22 22 22 22 22 22 22 22 22 22
22 22 22 22 22 22 22 22 22 22 22 22 22 22 22 22 22 22 22 22 22 22 22 22 22 22 22 22 22 22 22 22 22 22 22 22 22 22 22 22 22 22 22 22 22 22 22 22 22 22 
22 22 22 22 22 22 22 22 22 22 22 22 22 22 22 22 22 22 22 22 22 22 22 22 22 22 22 22 22 22 22 22 22 22 22 22 22 22 22 22 22 22 22 22 22 22 22 22 22 22